{
  "name": "Замок",
  "number": 12,
  "size": 15,
  "difficulty": 4,
  "solution": [
    [0, 1, 0, 1, 0, 1, 1, 1, 0, 1, 0, 1, 0, 0, 0],
    [0, 1, 0, 1, 0, 1, 0, 1, 0, 1, 0, 1, 0, 0, 0],
    [1, 1, 1, 1, 1, 1, 1, 1, 1, 1, 1, 1, 1, 0, 0],
    [1, 0, 0, 1, 0, 0, 0, 0, 0, 1, 0, 0, 1, 0, 0],
    [1, 0, 0, 1, 0, 0, 0, 0, 0, 1, 0, 0, 1, 0, 0],
    [1, 0, 0, 1, 0, 0, 0, 0, 0, 1, 0, 0, 1, 0, 0],
    [1, 1, 1, 1, 0, 0, 0, 0, 0, 1, 1, 1, 1, 0, 0],
    [1, 0, 0, 0, 0, 0, 0, 0, 0, 0, 0, 0, 1, 0, 0],
    [1, 0, 0, 0, 0, 0, 0, 0, 0, 0, 0, 0, 1, 0, 0],
    [1, 0, 0, 0, 1, 1, 1, 1, 1, 0, 0, 0, 1, 0, 0],
    [1, 0, 0, 0, 1, 0, 0, 0, 1, 0, 0, 0, 1, 0, 0],
    [1, 0, 0, 0, 1, 0, 0, 0, 1, 0, 0, 0, 1, 0, 0],
    [1, 1, 1, 1, 1, 0, 0, 0, 1, 1, 1, 1, 1, 0, 0],
    [0, 0, 0, 0, 0, 0, 0, 0, 0, 0, 0, 0, 0, 0, 0],
    [0, 0, 0, 0, 0, 0, 0, 0, 0, 0, 0, 0, 0, 0, 0]
  ]
}