{
  "name": "Замок",
  "number": 12,
  "size": 15,
  "difficulty": 4,
  "solution": [
    [0, 1, 0, 1, 0, 1, 1, 1, 0, 1, 0, 1, 0, 0, 0],
    [0, 1, 0, 1, 0, 1, 0, 1, 0, 1, 0, 1, 0, 0, 0],
    [1, 1, 1, 1, 1, 1, 1, 1, 1, 1, 1, 1, 1, 0, 0],
    [1, 0, 0, 1, 0, 0, 0, 0, 0, 1, 0, 0, 1, 0, 0],
    [1, 0, 0, 1, 0, 0, 0, 0, 0, 1, 0, 0, 1, 0, 0],
    [1, 0, 0, 1, 0, 0, 0, 0, 0, 1, 0, 0, 1, 0, 0],
    [1, 1, 1, 1, 0, 0, 0, 0, 0, 1, 1, 1, 1, 0, 0],
    [1, 0, 0, 0, 0, 0, 0, 0, 0, 0, 0, 0, 1, 0, 0],
    [1, 0, 0, 0, 0, 0, 0, 0, 0, 0, 0, 0, 1, 0, 0],
    [1, 0, 0, 0, 1, 1, 1, 1, 1, 0, 0, 0, 1, 0, 0],
    [1, 0, 0, 0, 1, 0, 0, 0, 1, 0, 0, 0, 1, 0, 0],
    [1, 0, 0, 0, 1, 0, 0, 0, 1, 0, 0, 0, 1, 0, 0],
    [1, 1, 1, 1, 1, 0, 0, 0, 1, 1, 1, 1, 1, 0, 0],
    [0, 0, 0, 0, 0, 0, 0, 0, 0, 0, 0, 0, 0, 0, 0],
    [0, 0, 0, 0, 0, 0, 0, 0, 0, 0, 0, 0, 0, 0, 0]
  ],
  "rows_hints": [
    [1, 1, 3, 1, 1],
    [1, 1, 1, 1, 1, 1],
    [13],
    [1, 1, 1, 1],
    [1, 1, 1, 1],
    [1, 1, 1, 1],
    [4, 4],
    [1, 1],
    [1, 1],
    [1, 5, 1],
    [1, 1, 1, 1],
    [1, 1, 1, 1],
    [5, 5],
    [],
    []
  ],
  "cols_hints": [
    [11],
    [3, 1, 1],
    [1, 1, 1],
    [7, 1],
    [1, 4],
    [3, 1],
    [1, 1, 1],
    [3, 1],
    [1, 4],
    [7, 1],
    [1, 1, 1],
    [3, 1, 1],
    [11],
    [],
    []
  ]
}