{
  "name": "Сердце",
  "number": 15,
  "size": 15,
  "preview": "images/bigheart.png",
  "difficulty": 3,
  "solution": [
    [0, 0, 0, 0, 0, 0, 0, 0, 0, 0, 0, 0, 0, 0, 0],
    [0, 0, 0, 0, 0, 0, 0, 0, 0, 0, 0, 0, 0, 0, 0],
    [0, 0, 0, 1, 1, 0, 0, 0, 0, 0, 1, 1, 0, 0, 0],
    [0, 0, 1, 1, 1, 1, 0, 0, 0, 1, 1, 1, 1, 0, 0],
    [0, 1, 1, 1, 1, 1, 1, 0, 1, 1, 1, 1, 1, 1, 0],
    [1, 1, 1, 1, 1, 1, 1, 1, 1, 1, 1, 1, 1, 1, 1],
    [1, 1, 1, 1, 1, 1, 1, 1, 1, 1, 1, 1, 1, 1, 1],
    [1, 1, 1, 1, 1, 1, 1, 1, 1, 1, 1, 1, 1, 1, 1],
    [0, 1, 1, 1, 1, 1, 1, 1, 1, 1, 1, 1, 1, 1, 0],
    [0, 0, 1, 1, 1, 1, 1, 1, 1, 1, 1, 1, 1, 0, 0],
    [0, 0, 0, 1, 1, 1, 1, 1, 1, 1, 1, 1, 0, 0, 0],
    [0, 0, 0, 0, 1, 1, 1, 1, 1, 1, 1, 0, 0, 0, 0],
    [0, 0, 0, 0, 0, 1, 1, 1, 1, 1, 0, 0, 0, 0, 0],
    [0, 0, 0, 0, 0, 0, 1, 1, 1, 0, 0, 0, 0, 0, 0],
    [0, 0, 0, 0, 0, 0, 0, 1, 0, 0, 0, 0, 0, 0, 0]
  ],
  "rows_hints": [
    [],
    [],
    [2, 2],
    [4, 4],
    [6, 6],
    [15],
    [15],
    [15],
    [13],
    [11],
    [9],
    [7],
    [5],
    [3],
    [1]
  ],
  "cols_hints": [
    [3],
    [5],
    [7],
    [9],
    [10],
    [10],
    [10],
    [10],
    [10],
    [10],
    [10],
    [9],
    [7],
    [5],
    [3]
  ]
}