{
  "name": "Кошка",
  "number": 13,
  "size": 15,
  "difficulty": 3,
  "solution": [
    [0, 0, 0, 0, 0, 1, 1, 0, 0, 0, 0, 0, 0, 0, 0],
    [0, 0, 0, 0, 1, 0, 0, 1, 0, 0, 0, 0, 0, 0, 0],
    [0, 0, 0, 1, 0, 0, 0, 0, 1, 0, 0, 0, 0, 0, 0],
    [0, 0, 0, 1, 0, 0, 0, 0, 1, 0, 0, 0, 0, 0, 0],
    [0, 0, 1, 1, 1, 1, 1, 1, 1, 1, 0, 0, 0, 0, 0],
    [0, 0, 1, 0, 0, 0, 0, 0, 0, 1, 0, 0, 0, 0, 0],
    [0, 0, 1, 0, 0, 0, 0, 0, 0, 1, 0, 0, 0, 0, 0],
    [0, 0, 1, 0, 0, 0, 0, 0, 0, 1, 0, 0, 0, 0, 0],
    [0, 0, 1, 0, 0, 0, 0, 0, 0, 1, 0, 0, 0, 0, 0],
    [0, 0, 1, 1, 1, 0, 0, 1, 1, 1, 0, 0, 0, 0, 0],
    [0, 0, 0, 0, 0, 1, 1, 0, 0, 0, 0, 0, 0, 0, 0],
    [0, 0, 0, 0, 0, 1, 1, 0, 0, 0, 0, 0, 0, 0, 0],
    [0, 0, 0, 0, 1, 0, 0, 1, 0, 0, 0, 0, 0, 0, 0],
    [0, 0, 0, 1, 0, 0, 0, 0, 1, 0, 0, 0, 0, 0, 0],
    [0, 0, 0, 0, 0, 0, 0, 0, 0, 0, 0, 0, 0, 0, 0]
  ],
  "rows_hints": [
    [2],
    [1, 1],
    [1, 1],
    [1, 1],
    [8],
    [1, 1],
    [1, 1],
    [1, 1],
    [1, 1],
    [3, 3],
    [2],
    [2],
    [1, 1],
    [1, 1],
    []
  ],
  "cols_hints": [
    [],
    [],
    [6],
    [3, 1, 1],
    [1, 1, 1, 1],
    [1, 1, 2],
    [1, 1, 2],
    [1, 1, 1, 1],
    [3, 1, 1],
    [6],
    [],
    [],
    [],
    [],
    []
  ]
}