{
  "name": "Веер",
  "number": 14,
  "size": 15,
  "difficulty": 3,
  "solution": [
    [0, 0, 0, 0, 0, 0, 1, 0, 0, 0, 0, 0, 0, 0, 0],
    [0, 0, 0, 0, 0, 1, 1, 1, 0, 0, 0, 0, 0, 0, 0],
    [0, 0, 0, 0, 1, 0, 1, 0, 1, 0, 0, 0, 0, 0, 0],
    [0, 0, 0, 1, 0, 0, 1, 0, 0, 1, 0, 0, 0, 0, 0],
    [0, 0, 1, 0, 0, 0, 1, 0, 0, 0, 1, 0, 0, 0, 0],
    [0, 1, 0, 0, 0, 0, 1, 0, 0, 0, 0, 1, 0, 0, 0],
    [1, 0, 0, 0, 0, 0, 1, 0, 0, 0, 0, 0, 1, 0, 0],
    [1, 1, 1, 1, 1, 1, 1, 1, 1, 1, 1, 1, 1, 0, 0],
    [0, 1, 1, 1, 1, 1, 1, 1, 1, 1, 1, 1, 0, 0, 0],
    [0, 0, 1, 1, 1, 1, 1, 1, 1, 1, 1, 0, 0, 0, 0],
    [0, 0, 0, 1, 1, 1, 1, 1, 1, 1, 0, 0, 0, 0, 0],
    [0, 0, 0, 0, 1, 1, 1, 1, 1, 0, 0, 0, 0, 0, 0],
    [0, 0, 0, 0, 0, 1, 1, 1, 0, 0, 0, 0, 0, 0, 0],
    [0, 0, 0, 0, 0, 0, 1, 0, 0, 0, 0, 0, 0, 0, 0],
    [0, 0, 0, 0, 0, 0, 0, 0, 0, 0, 0, 0, 0, 0, 0]
  ],
  "rows_hints": [
    [1],
    [3],
    [1, 1, 1],
    [1, 1, 1],
    [1, 1, 1],
    [1, 1, 1],
    [1, 1, 1],
    [13],
    [11],
    [9],
    [7],
    [5],
    [3],
    [1],
    []
  ],
  "cols_hints": [
    [2],
    [1, 2],
    [1, 3],
    [1, 4],
    [1, 5],
    [1, 6],
    [14],
    [1, 6],
    [1, 5],
    [1, 4],
    [1, 3],
    [1, 2],
    [2],
    [],
    []
  ]
}